6,7,8,9,6,7,8,9,6,7,8,9,6,7,8,9,6,7,8,9,6,7,8,9,6,7,8,9,6,7,8,9,6,7,8,9,6,7,8,9,6,7,8,9,6,7,8,9,6,7,8,9,6,7,8,9,6,7,8,9,6,7,8,9,6,7,8,9,6,7,8,9,6,7,8,9,6,7,8,9,6,7,8,9,6,7,8,9,6,7,8,9,6,7,8,9,6,7,8,9
16,17,18,19,16,17,18,19,16,17,18,19,16,17,18,19,16,17,18,19,16,17,18,19,16,17,18,19,16,17,18,19,16,17,18,19,16,17,18,19,16,17,18,19,16,17,18,19,16,17,18,19,16,17,18,19,16,17,18,19,16,17,18,19,16,17,18,19,16,17,18,19,16,17,18,19,16,17,18,19,16,17,18,19,16,17,18,19,16,17,18,19,16,17,18,19,16,17,18,19
26,27,28,29,26,27,28,29,26,27,28,29,26,27,28,29,26,27,28,29,26,27,28,29,26,27,28,29,26,27,28,29,26,27,28,29,26,27,28,29,26,27,28,29,26,27,28,29,26,27,28,29,26,27,28,29,26,27,28,29,26,27,28,29,26,27,28,29,26,27,28,29,26,27,28,29,26,27,28,29,26,27,28,29,26,27,28,29,26,27,28,29,26,27,28,29,26,27,28,29
6,7,8,9,6,7,8,9,6,7,8,9,6,7,8,9,6,7,8,9,6,7,8,9,6,7,8,9,6,7,8,9,6,7,8,9,6,7,8,9,6,7,8,9,6,7,8,9,6,7,8,9,6,7,8,9,6,7,8,9,6,7,8,9,6,7,8,9,6,7,8,9,6,7,8,9,6,7,8,9,6,7,8,9,6,7,8,9,6,7,8,9,6,7,8,9,6,7,8,9
16,17,18,19,16,17,18,19,16,17,18,19,16,17,18,19,16,17,18,19,16,17,18,19,16,17,18,19,16,17,18,19,16,17,18,19,16,17,18,19,16,17,18,19,16,17,18,19,16,17,18,19,16,17,18,19,16,17,18,19,16,17,18,19,16,17,18,19,16,17,18,19,16,17,18,19,16,17,18,19,16,17,18,19,16,17,18,19,16,17,18,19,16,17,18,19,16,17,18,19
26,27,28,29,26,27,28,29,26,27,28,29,26,27,28,29,26,27,28,29,26,27,28,29,26,27,28,29,26,27,28,29,26,27,28,29,26,27,28,29,26,27,28,29,26,27,28,29,26,27,28,29,26,27,28,29,26,27,28,29,26,27,28,29,26,27,28,29,26,27,28,29,26,27,28,29,26,27,28,29,26,27,28,29,26,27,28,29,26,27,28,29,26,27,28,29,26,27,28,29
6,7,8,9,6,7,8,9,6,7,8,9,6,7,8,9,6,7,8,9,6,7,8,9,6,7,8,9,6,7,8,9,6,7,8,9,6,7,8,9,6,7,8,9,6,7,8,9,6,7,8,9,6,7,8,9,6,7,8,9,6,7,8,9,6,7,8,9,6,7,8,9,6,7,8,9,6,7,8,9,6,7,8,9,6,7,8,9,6,7,8,9,6,7,8,9,6,7,8,9
16,17,18,19,16,17,18,19,16,17,18,19,16,17,18,19,16,17,18,19,16,17,18,19,16,17,18,19,16,17,18,19,16,17,18,19,16,17,18,19,16,17,18,19,16,17,18,19,16,17,18,19,16,17,18,19,16,17,18,19,16,17,18,19,16,17,18,19,16,17,18,19,16,17,18,19,16,17,18,19,16,17,18,19,16,17,18,19,16,17,18,19,16,17,18,19,16,17,18,19
26,27,28,29,26,27,28,29,26,27,28,29,26,27,28,29,26,27,28,29,26,27,28,29,26,27,28,29,26,27,28,29,26,27,28,29,26,27,28,29,26,27,28,29,26,27,28,29,26,27,28,29,26,27,28,29,26,27,28,29,26,27,28,29,26,27,28,29,26,27,28,29,26,27,28,29,26,27,28,29,26,27,28,29,26,27,28,29,26,27,28,29,26,27,28,29,26,27,28,29
6,7,8,9,6,7,8,9,6,7,8,9,6,7,8,9,6,7,8,9,6,7,8,9,6,7,8,9,6,7,8,9,6,7,8,9,6,7,8,9,6,7,8,9,6,7,8,9,6,7,8,9,6,7,8,9,6,7,8,9,6,7,8,9,6,7,8,9,6,7,8,9,6,7,8,9,6,7,8,9,6,7,8,9,6,7,8,9,6,7,8,9,6,7,8,9,6,7,8,9
16,17,18,19,16,17,18,19,16,17,18,19,16,17,18,19,16,17,18,19,16,17,18,19,16,17,18,19,16,17,18,19,16,17,18,19,16,17,18,19,16,17,18,19,16,17,18,19,16,17,18,19,16,17,18,19,16,17,18,19,16,17,18,19,16,17,18,19,16,17,18,19,16,17,18,19,16,17,18,19,16,17,18,19,16,17,18,19,16,17,18,19,16,17,18,19,16,17,18,19
26,27,28,29,26,27,28,29,26,27,28,29,26,27,28,29,26,27,28,29,26,27,28,29,26,27,28,29,26,27,28,29,26,27,28,29,26,27,28,29,26,27,28,29,26,27,28,29,26,27,28,29,26,27,28,29,26,27,28,29,26,27,28,29,26,27,28,29,26,27,28,29,26,27,28,29,26,27,28,29,26,27,28,29,26,27,28,29,26,27,28,29,26,27,28,29,26,27,28,29
6,7,8,9,6,7,8,9,6,7,8,9,6,7,8,9,6,7,8,9,6,7,8,9,6,7,8,9,6,7,8,9,6,7,8,9,6,7,8,9,6,7,8,9,6,7,8,9,6,7,8,9,6,7,8,9,6,7,8,9,6,7,8,9,6,7,8,9,6,7,8,9,6,7,8,9,6,7,8,9,6,7,8,9,6,7,8,9,6,7,8,9,6,7,8,9,6,7,8,9
16,17,18,19,16,17,18,19,16,17,18,19,16,17,18,19,16,17,18,19,16,17,18,19,16,17,18,19,16,17,18,19,16,17,18,19,16,17,18,19,16,17,18,19,16,17,18,19,16,17,18,19,16,17,18,19,16,17,18,19,16,17,18,19,16,17,18,19,16,17,18,19,16,17,18,19,16,17,18,19,16,17,18,19,16,17,18,19,16,17,18,19,16,17,18,19,16,17,18,19
26,27,28,29,26,27,28,29,26,27,28,29,26,27,28,29,26,27,28,29,26,27,28,29,26,27,28,29,26,27,28,29,26,27,28,29,26,27,28,29,26,27,28,29,26,27,28,29,26,27,28,29,26,27,28,29,26,27,28,29,26,27,28,29,26,27,28,29,26,27,28,29,26,27,28,29,26,27,28,29,26,27,28,29,26,27,28,29,26,27,28,29,26,27,28,29,26,27,28,29
6,7,8,9,6,7,8,9,6,7,8,9,6,7,8,9,6,7,8,9,6,7,8,9,6,7,8,9,6,7,8,9,6,7,8,9,6,7,8,9,6,7,8,9,6,7,8,9,6,7,8,9,6,7,8,9,6,7,8,9,6,7,8,9,6,7,8,9,6,7,8,9,6,7,8,9,6,7,8,9,6,7,8,9,6,7,8,9,6,7,8,9,6,7,8,9,6,7,8,9
16,17,18,19,16,17,18,19,16,17,18,19,16,17,18,19,16,17,18,19,16,17,18,19,16,17,18,19,16,17,18,19,16,17,18,19,16,17,18,19,16,17,18,19,16,17,18,19,16,17,18,19,16,17,18,19,16,17,18,19,16,17,18,19,16,17,18,19,16,17,18,19,16,17,18,19,16,17,18,19,16,17,18,19,16,17,18,19,16,17,18,19,16,17,18,19,16,17,18,19
26,27,28,29,26,27,28,29,26,27,28,29,26,27,28,29,26,27,28,29,26,27,28,29,26,27,28,29,26,27,28,29,26,27,28,29,26,27,28,29,26,27,28,29,26,27,28,29,26,27,28,29,26,27,28,29,26,27,28,29,26,27,28,29,26,27,28,29,26,27,28,29,26,27,28,29,26,27,28,29,26,27,28,29,26,27,28,29,26,27,28,29,26,27,28,29,26,27,28,29
6,7,8,9,6,7,8,9,6,7,8,9,6,7,8,9,6,7,8,9,6,7,8,9,6,7,8,9,6,7,8,9,6,7,8,9,6,7,8,9,6,7,8,9,6,7,8,9,6,7,8,9,6,7,8,9,6,7,8,9,6,7,8,9,6,7,8,9,6,7,8,9,6,7,8,9,6,7,8,9,6,7,8,9,6,7,8,9,6,7,8,9,6,7,8,9,6,7,8,9
16,17,18,19,16,17,18,19,16,17,18,19,16,17,18,19,16,17,18,19,16,17,18,19,16,17,18,19,16,17,18,19,16,17,18,19,16,17,18,19,16,17,18,19,16,17,18,19,16,17,18,19,16,17,18,19,16,17,18,19,16,17,18,19,16,17,18,19,16,17,18,19,16,17,18,19,16,17,18,19,16,17,18,19,16,17,18,19,16,17,18,19,16,17,18,19,16,17,18,19
26,27,28,29,26,27,28,29,26,27,28,29,26,27,28,29,26,27,28,29,26,27,28,29,26,27,28,29,26,27,28,29,26,27,28,29,26,27,28,29,26,27,28,29,26,27,28,29,26,27,28,29,26,27,28,29,26,27,28,29,26,27,28,29,26,27,28,29,26,27,28,29,26,27,28,29,26,27,28,29,26,27,28,29,26,27,28,29,26,27,28,29,26,27,28,29,26,27,28,29
6,7,8,9,6,7,8,9,6,7,8,9,6,7,8,9,6,7,8,9,6,7,8,9,6,7,8,9,6,7,8,9,6,7,8,9,6,7,8,9,6,7,8,9,6,7,8,9,6,7,8,9,6,7,8,9,6,7,8,9,6,7,8,9,6,7,8,9,6,7,8,9,6,7,8,9,6,7,8,9,6,7,8,9,6,7,8,9,6,7,8,9,6,7,8,9,6,7,8,9
16,17,18,19,16,17,18,19,16,17,18,19,16,17,18,19,16,17,18,19,16,17,18,19,16,17,18,19,16,17,18,19,16,17,18,19,16,17,18,19,16,17,18,19,16,17,18,19,16,17,18,19,16,17,18,19,16,17,18,19,16,17,18,19,16,17,18,19,16,17,18,19,16,17,18,19,16,17,18,19,16,17,18,19,16,17,18,19,16,17,18,19,16,17,18,19,16,17,18,19
26,27,28,29,26,27,28,29,26,27,28,29,26,27,28,29,26,27,28,29,26,27,28,29,26,27,28,29,26,27,28,29,26,27,28,29,26,27,28,29,26,27,28,29,26,27,28,29,26,27,28,29,26,27,28,29,26,27,28,29,26,27,28,29,26,27,28,29,26,27,28,29,26,27,28,29,26,27,28,29,26,27,28,29,26,27,28,29,26,27,28,29,26,27,28,29,26,27,28,29
6,7,8,9,6,7,8,9,6,7,8,9,6,7,8,9,6,7,8,9,6,7,8,9,6,7,8,9,6,7,8,9,6,7,8,9,6,7,8,9,6,7,8,9,6,7,8,9,6,7,8,9,6,7,8,9,6,7,8,9,6,7,8,9,6,7,8,9,6,7,8,9,6,7,8,9,6,7,8,9,6,7,8,9,6,7,8,9,6,7,8,9,6,7,8,9,6,7,8,9
16,17,18,19,16,17,18,19,16,17,18,19,16,17,18,19,16,17,18,19,16,17,18,19,16,17,18,19,16,17,18,19,16,17,18,19,16,17,18,19,16,17,18,19,16,17,18,19,16,17,18,19,16,17,18,19,16,17,18,19,16,17,18,19,16,17,18,19,16,17,18,19,16,17,18,19,16,17,18,19,16,17,18,19,16,17,18,19,16,17,18,19,16,17,18,19,16,17,18,19
26,27,28,29,26,27,28,29,26,27,28,29,26,27,28,29,26,27,28,29,26,27,28,29,26,27,28,29,26,27,28,29,26,27,28,29,26,27,28,29,26,27,28,29,26,27,28,29,26,27,28,29,26,27,28,29,26,27,28,29,26,27,28,29,26,27,28,29,26,27,28,29,26,27,28,29,26,27,28,29,26,27,28,29,26,27,28,29,26,27,28,29,26,27,28,29,26,27,28,29
6,7,8,9,6,7,8,9,6,7,8,9,6,7,8,9,6,7,8,9,6,7,8,9,6,7,8,9,6,7,8,9,6,7,8,9,6,7,8,9,6,7,8,9,6,7,8,9,6,7,8,9,6,7,8,9,6,7,8,9,6,7,8,9,6,7,8,9,6,7,8,9,6,7,8,9,6,7,8,9,6,7,8,9,6,7,8,9,6,7,8,9,6,7,8,9,6,7,8,9
16,17,18,19,16,17,18,19,16,17,18,19,16,17,18,19,16,17,18,19,16,17,18,19,16,17,18,19,16,17,18,19,16,17,18,19,16,17,18,19,16,17,18,19,16,17,18,19,16,17,18,19,16,17,18,19,16,17,18,19,16,17,18,19,16,17,18,19,16,17,18,19,16,17,18,19,16,17,18,19,16,17,18,19,16,17,18,19,16,17,18,19,16,17,18,19,16,17,18,19
26,27,28,29,26,27,28,29,26,27,28,29,26,27,28,29,26,27,28,29,26,27,28,29,26,27,28,29,26,27,28,29,26,27,28,29,26,27,28,29,26,27,28,29,26,27,28,29,26,27,28,29,26,27,28,29,26,27,28,29,26,27,28,29,26,27,28,29,26,27,28,29,26,27,28,29,26,27,28,29,26,27,28,29,26,27,28,29,26,27,28,29,26,27,28,29,26,27,28,29
6,7,8,9,6,7,8,9,6,7,8,9,6,7,8,9,6,7,8,9,6,7,8,9,6,7,8,9,6,7,8,9,6,7,8,9,6,7,8,9,6,7,8,9,6,7,8,9,6,7,8,9,6,7,8,9,6,7,8,9,6,7,8,9,6,7,8,9,6,7,8,9,6,7,8,9,6,7,8,9,6,7,8,9,6,7,8,9,6,7,8,9,6,7,8,9,6,7,8,9
16,17,18,19,16,17,18,19,16,17,18,19,16,17,18,19,16,17,18,19,16,17,18,19,16,17,18,19,16,17,18,19,16,17,18,19,16,17,18,19,16,17,18,19,16,17,18,19,16,17,18,19,16,17,18,19,16,17,18,19,16,17,18,19,16,17,18,19,16,17,18,19,16,17,18,19,16,17,18,19,16,17,18,19,16,17,18,19,16,17,18,19,16,17,18,19,16,17,18,19
26,27,28,29,26,27,28,29,26,27,28,29,26,27,28,29,26,27,28,29,26,27,28,29,26,27,28,29,26,27,28,29,26,27,28,29,26,27,28,29,26,27,28,29,26,27,28,29,26,27,28,29,26,27,28,29,26,27,28,29,26,27,28,29,26,27,28,29,26,27,28,29,26,27,28,29,26,27,28,29,26,27,28,29,26,27,28,29,26,27,28,29,26,27,28,29,26,27,28,29
6,7,8,9,6,7,8,9,6,7,8,9,6,7,8,9,6,7,8,9,6,7,8,9,6,7,8,9,6,7,8,9,6,7,8,9,6,7,8,9,6,7,8,9,6,7,8,9,6,7,8,9,6,7,8,9,6,7,8,9,6,7,8,9,6,7,8,9,6,7,8,9,6,7,8,9,6,7,8,9,6,7,8,9,6,7,8,9,6,7,8,9,6,7,8,9,6,7,8,9
16,17,18,19,16,17,18,19,16,17,18,19,16,17,18,19,16,17,18,19,16,17,18,19,16,17,18,19,16,17,18,19,16,17,18,19,16,17,18,19,16,17,18,19,16,17,18,19,16,17,18,19,16,17,18,19,16,17,18,19,16,17,18,19,16,17,18,19,16,17,18,19,16,17,18,19,16,17,18,19,16,17,18,19,16,17,18,19,16,17,18,19,16,17,18,19,16,17,18,19
26,27,28,29,26,27,28,29,26,27,28,29,26,27,28,29,26,27,28,29,26,27,28,29,26,27,28,29,26,27,28,29,26,27,28,29,26,27,28,29,26,27,28,29,26,27,28,29,26,27,28,29,26,27,28,29,26,27,28,29,26,27,28,29,26,27,28,29,26,27,28,29,26,27,28,29,26,27,28,29,26,27,28,29,26,27,28,29,26,27,28,29,26,27,28,29,26,27,28,29
6,7,8,9,6,7,8,9,6,7,8,9,6,7,8,9,6,7,8,9,6,7,8,9,6,7,8,9,6,7,8,9,6,7,8,9,6,7,8,9,6,7,8,9,6,7,8,9,6,7,8,9,6,7,8,9,6,7,8,9,6,7,8,9,6,7,8,9,6,7,8,9,6,7,8,9,6,7,8,9,6,7,8,9,6,7,8,9,6,7,8,9,6,7,8,9,6,7,8,9
16,17,18,19,16,17,18,19,16,17,18,19,16,17,18,19,16,17,18,19,16,17,18,19,16,17,18,19,16,17,18,19,16,17,18,19,16,17,18,19,16,17,18,19,16,17,18,19,16,17,18,19,16,17,18,19,16,17,18,19,16,17,18,19,16,17,18,19,16,17,18,19,16,17,18,19,16,17,18,19,16,17,18,19,16,17,18,19,16,17,18,19,16,17,18,19,16,17,18,19
26,27,28,29,26,27,28,29,26,27,28,29,26,27,28,29,26,27,28,29,26,27,28,29,26,27,28,29,26,27,28,29,26,27,28,29,26,27,28,29,26,27,28,29,26,27,28,29,26,27,28,29,26,27,28,29,26,27,28,29,26,27,28,29,26,27,28,29,26,27,28,29,26,27,28,29,26,27,28,29,26,27,28,29,26,27,28,29,26,27,28,29,26,27,28,29,26,27,28,29
6,7,8,9,6,7,8,9,6,7,8,9,6,7,8,9,6,7,8,9,6,7,8,9,6,7,8,9,6,7,8,9,6,7,8,9,6,7,8,9,6,7,8,9,6,7,8,9,6,7,8,9,6,7,8,9,6,7,8,9,6,7,8,9,6,7,8,9,6,7,8,9,6,7,8,9,6,7,8,9,6,7,8,9,6,7,8,9,6,7,8,9,6,7,8,9,6,7,8,9
16,17,18,19,16,17,18,19,16,17,18,19,16,17,18,19,16,17,18,19,16,17,18,19,16,17,18,19,16,17,18,19,16,17,18,19,16,17,18,19,16,17,18,19,16,17,18,19,16,17,18,19,16,17,18,19,16,17,18,19,16,17,18,19,16,17,18,19,16,17,18,19,16,17,18,19,16,17,18,19,16,17,18,19,16,17,18,19,16,17,18,19,16,17,18,19,16,17,18,19
26,27,28,29,26,27,28,29,26,27,28,29,26,27,28,29,26,27,28,29,26,27,28,29,26,27,28,29,26,27,28,29,26,27,28,29,26,27,28,29,26,27,28,29,26,27,28,29,26,27,28,29,26,27,28,29,26,27,28,29,26,27,28,29,26,27,28,29,26,27,28,29,26,27,28,29,26,27,28,29,26,27,28,29,26,27,28,29,26,27,28,29,26,27,28,29,26,27,28,29
6,7,8,9,6,7,8,9,6,7,8,9,6,7,8,9,6,7,8,9,6,7,8,9,6,7,8,9,6,7,8,9,6,7,8,9,6,7,8,9,6,7,8,9,6,7,8,9,6,7,8,9,6,7,8,9,6,7,8,9,6,7,8,9,6,7,8,9,6,7,8,9,6,7,8,9,6,7,8,9,6,7,8,9,6,7,8,9,6,7,8,9,6,7,8,9,6,7,8,9
16,17,18,19,16,17,18,19,16,17,18,19,16,17,18,19,16,17,18,19,16,17,18,19,16,17,18,19,16,17,18,19,16,17,18,19,16,17,18,19,16,17,18,19,16,17,18,19,16,17,18,19,16,17,18,19,16,17,18,19,16,17,18,19,16,17,18,19,16,17,18,19,16,17,18,19,16,17,18,19,16,17,18,19,16,17,18,19,16,17,18,19,16,17,18,19,16,17,18,19
26,27,28,29,26,27,28,29,26,27,28,29,26,27,28,29,26,27,28,29,26,27,28,29,26,27,28,29,26,27,28,29,26,27,28,29,26,27,28,29,26,27,28,29,26,27,28,29,26,27,28,29,26,27,28,29,26,27,28,29,26,27,28,29,26,27,28,29,26,27,28,29,26,27,28,29,26,27,28,29,26,27,28,29,26,27,28,29,26,27,28,29,26,27,28,29,26,27,28,29
6,7,8,9,6,7,8,9,6,7,8,9,6,7,8,9,6,7,8,9,6,7,8,9,6,7,8,9,6,7,8,9,6,7,8,9,6,7,8,9,6,7,8,9,6,7,8,9,6,7,8,9,6,7,8,9,6,7,8,9,6,7,8,9,6,7,8,9,6,7,8,9,6,7,8,9,6,7,8,9,6,7,8,9,6,7,8,9,6,7,8,9,6,7,8,9,6,7,8,9
16,17,18,19,16,17,18,19,16,17,18,19,16,17,18,19,16,17,18,19,16,17,18,19,16,17,18,19,16,17,18,19,16,17,18,19,16,17,18,19,16,17,18,19,16,17,18,19,16,17,18,19,16,17,18,19,16,17,18,19,16,17,18,19,16,17,18,19,16,17,18,19,16,17,18,19,16,17,18,19,16,17,18,19,16,17,18,19,16,17,18,19,16,17,18,19,16,17,18,19
26,27,28,29,26,27,28,29,26,27,28,29,26,27,28,29,26,27,28,29,26,27,28,29,26,27,28,29,26,27,28,29,26,27,28,29,26,27,28,29,26,27,28,29,26,27,28,29,26,27,28,29,26,27,28,29,26,27,28,29,26,27,28,29,26,27,28,29,26,27,28,29,26,27,28,29,26,27,28,29,26,27,28,29,26,27,28,29,26,27,28,29,26,27,28,29,26,27,28,29
6,7,8,9,6,7,8,9,6,7,8,9,6,7,8,9,6,7,8,9,6,7,8,9,6,7,8,9,6,7,8,9,6,7,8,9,6,7,8,9,6,7,8,9,6,7,8,9,6,7,8,9,6,7,8,9,6,7,8,9,6,7,8,9,6,7,8,9,6,7,8,9,6,7,8,9,6,7,8,9,6,7,8,9,6,7,8,9,6,7,8,9,6,7,8,9,6,7,8,9
16,17,18,19,16,17,18,19,16,17,18,19,16,17,18,19,16,17,18,19,16,17,18,19,16,17,18,19,16,17,18,19,16,17,18,19,16,17,18,19,16,17,18,19,16,17,18,19,16,17,18,19,16,17,18,19,16,17,18,19,16,17,18,19,16,17,18,19,16,17,18,19,16,17,18,19,16,17,18,19,16,17,18,19,16,17,18,19,16,17,18,19,16,17,18,19,16,17,18,19
26,27,28,29,26,27,28,29,26,27,28,29,26,27,28,29,26,27,28,29,26,27,28,29,26,27,28,29,26,27,28,29,26,27,28,29,26,27,28,29,26,27,28,29,26,27,28,29,26,27,28,29,26,27,28,29,26,27,28,29,26,27,28,29,26,27,28,29,26,27,28,29,26,27,28,29,26,27,28,29,26,27,28,29,26,27,28,29,26,27,28,29,26,27,28,29,26,27,28,29
6,7,8,9,6,7,8,9,6,7,8,9,6,7,8,9,6,7,8,9,6,7,8,9,6,7,8,9,6,7,8,9,6,7,8,9,6,7,8,9,6,7,8,9,6,7,8,9,6,7,8,9,6,7,8,9,6,7,8,9,6,7,8,9,6,7,8,9,6,7,8,9,6,7,8,9,6,7,8,9,6,7,8,9,6,7,8,9,6,7,8,9,6,7,8,9,6,7,8,9
16,17,18,19,16,17,18,19,16,17,18,19,16,17,18,19,16,17,18,19,16,17,18,19,16,17,18,19,16,17,18,19,16,17,18,19,16,17,18,19,16,17,18,19,16,17,18,19,16,17,18,19,16,17,18,19,16,17,18,19,16,17,18,19,16,17,18,19,16,17,18,19,16,17,18,19,16,17,18,19,16,17,18,19,16,17,18,19,16,17,18,19,16,17,18,19,16,17,18,19
26,27,28,29,26,27,28,29,26,27,28,29,26,27,28,29,26,27,28,29,26,27,28,29,26,27,28,29,26,27,28,29,26,27,28,29,26,27,28,29,26,27,28,29,26,27,28,29,26,27,28,29,26,27,28,29,26,27,28,29,26,27,28,29,26,27,28,29,26,27,28,29,26,27,28,29,26,27,28,29,26,27,28,29,26,27,28,29,26,27,28,29,26,27,28,29,26,27,28,29
6,7,8,9,6,7,8,9,6,7,8,9,6,7,8,9,6,7,8,9,6,7,8,9,6,7,8,9,6,7,8,9,6,7,8,9,6,7,8,9,6,7,8,9,6,7,8,9,6,7,8,9,6,7,8,9,6,7,8,9,6,7,8,9,6,7,8,9,6,7,8,9,6,7,8,9,6,7,8,9,6,7,8,9,6,7,8,9,6,7,8,9,6,7,8,9,6,7,8,9
16,17,18,19,16,17,18,19,16,17,18,19,16,17,18,19,16,17,18,19,16,17,18,19,16,17,18,19,16,17,18,19,16,17,18,19,16,17,18,19,16,17,18,19,16,17,18,19,16,17,18,19,16,17,18,19,16,17,18,19,16,17,18,19,16,17,18,19,16,17,18,19,16,17,18,19,16,17,18,19,16,17,18,19,16,17,18,19,16,17,18,19,16,17,18,19,16,17,18,19
26,27,28,29,26,27,28,29,26,27,28,29,26,27,28,29,26,27,28,29,26,27,28,29,26,27,28,29,26,27,28,29,26,27,28,29,26,27,28,29,26,27,28,29,26,27,28,29,26,27,28,29,26,27,28,29,26,27,28,29,26,27,28,29,26,27,28,29,26,27,28,29,26,27,28,29,26,27,28,29,26,27,28,29,26,27,28,29,26,27,28,29,26,27,28,29,26,27,28,29
6,7,8,9,6,7,8,9,6,7,8,9,6,7,8,9,6,7,8,9,6,7,8,9,6,7,8,9,6,7,8,9,6,7,8,9,6,7,8,9,6,7,8,9,6,7,8,9,6,7,8,9,6,7,8,9,6,7,8,9,6,7,8,9,6,7,8,9,6,7,8,9,6,7,8,9,6,7,8,9,6,7,8,9,6,7,8,9,6,7,8,9,6,7,8,9,6,7,8,9
16,17,18,19,16,17,18,19,16,17,18,19,16,17,18,19,16,17,18,19,16,17,18,19,16,17,18,19,16,17,18,19,16,17,18,19,16,17,18,19,16,17,18,19,16,17,18,19,16,17,18,19,16,17,18,19,16,17,18,19,16,17,18,19,16,17,18,19,16,17,18,19,16,17,18,19,16,17,18,19,16,17,18,19,16,17,18,19,16,17,18,19,16,17,18,19,16,17,18,19
26,27,28,29,26,27,28,29,26,27,28,29,26,27,28,29,26,27,28,29,26,27,28,29,26,27,28,29,26,27,28,29,26,27,28,29,26,27,28,29,26,27,28,29,26,27,28,29,26,27,28,29,26,27,28,29,26,27,28,29,26,27,28,29,26,27,28,29,26,27,28,29,26,27,28,29,26,27,28,29,26,27,28,29,26,27,28,29,26,27,28,29,26,27,28,29,26,27,28,29
6,7,8,9,6,7,8,9,6,7,8,9,6,7,8,9,6,7,8,9,6,7,8,9,6,7,8,9,6,7,8,9,6,7,8,9,6,7,8,9,6,7,8,9,6,7,8,9,6,7,8,9,6,7,8,9,6,7,8,9,6,7,8,9,6,7,8,9,6,7,8,9,6,7,8,9,6,7,8,9,6,7,8,9,6,7,8,9,6,7,8,9,6,7,8,9,6,7,8,9
16,17,18,19,16,17,18,19,16,17,18,19,16,17,18,19,16,17,18,19,16,17,18,19,16,17,18,19,16,17,18,19,16,17,18,19,16,17,18,19,16,17,18,19,16,17,18,19,16,17,18,19,16,17,18,19,16,17,18,19,16,17,18,19,16,17,18,19,16,17,18,19,16,17,18,19,16,17,18,19,16,17,18,19,16,17,18,19,16,17,18,19,16,17,18,19,16,17,18,19
26,27,28,29,26,27,28,29,26,27,28,29,26,27,28,29,26,27,28,29,26,27,28,29,26,27,28,29,26,27,28,29,26,27,28,29,26,27,28,29,26,27,28,29,26,27,28,29,26,27,28,29,26,27,28,29,26,27,28,29,26,27,28,29,26,27,28,29,26,27,28,29,26,27,28,29,26,27,28,29,26,27,28,29,26,27,28,29,26,27,28,29,26,27,28,29,26,27,28,29
6,7,8,9,6,7,8,9,6,7,8,9,6,7,8,9,6,7,8,9,6,7,8,9,6,7,8,9,6,7,8,9,6,7,8,9,6,7,8,9,6,7,8,9,6,7,8,9,6,7,8,9,6,7,8,9,6,7,8,9,6,7,8,9,6,7,8,9,6,7,8,9,6,7,8,9,6,7,8,9,6,7,8,9,6,7,8,9,6,7,8,9,6,7,8,9,6,7,8,9
16,17,18,19,16,17,18,19,16,17,18,19,16,17,18,19,16,17,18,19,16,17,18,19,16,17,18,19,16,17,18,19,16,17,18,19,16,17,18,19,16,17,18,19,16,17,18,19,16,17,18,19,16,17,18,19,16,17,18,19,16,17,18,19,16,17,18,19,16,17,18,19,16,17,18,19,16,17,18,19,16,17,18,19,16,17,18,19,16,17,18,19,16,17,18,19,16,17,18,19
26,27,28,29,26,27,28,29,26,27,28,29,26,27,28,29,26,27,28,29,26,27,28,29,26,27,28,29,26,27,28,29,26,27,28,29,26,27,28,29,26,27,28,29,26,27,28,29,26,27,28,29,26,27,28,29,26,27,28,29,26,27,28,29,26,27,28,29,26,27,28,29,26,27,28,29,26,27,28,29,26,27,28,29,26,27,28,29,26,27,28,29,26,27,28,29,26,27,28,29
6,7,8,9,6,7,8,9,6,7,8,9,6,7,8,9,6,7,8,9,6,7,8,9,6,7,8,9,6,7,8,9,6,7,8,9,6,7,8,9,6,7,8,9,6,7,8,9,6,7,8,9,6,7,8,9,6,7,8,9,6,7,8,9,6,7,8,9,6,7,8,9,6,7,8,9,6,7,8,9,6,7,8,9,6,7,8,9,6,7,8,9,6,7,8,9,6,7,8,9
16,17,18,19,16,17,18,19,16,17,18,19,16,17,18,19,16,17,18,19,16,17,18,19,16,17,18,19,16,17,18,19,16,17,18,19,16,17,18,19,16,17,18,19,16,17,18,19,16,17,18,19,16,17,18,19,16,17,18,19,16,17,18,19,16,17,18,19,16,17,18,19,16,17,18,19,16,17,18,19,16,17,18,19,16,17,18,19,16,17,18,19,16,17,18,19,16,17,18,19
26,27,28,29,26,27,28,29,26,27,28,29,26,27,28,29,26,27,28,29,26,27,28,29,26,27,28,29,26,27,28,29,26,27,28,29,26,27,28,29,26,27,28,29,26,27,28,29,26,27,28,29,26,27,28,29,26,27,28,29,26,27,28,29,26,27,28,29,26,27,28,29,26,27,28,29,26,27,28,29,26,27,28,29,26,27,28,29,26,27,28,29,26,27,28,29,26,27,28,29
6,7,8,9,6,7,8,9,6,7,8,9,6,7,8,9,6,7,8,9,6,7,8,9,6,7,8,9,6,7,8,9,6,7,8,9,6,7,8,9,6,7,8,9,6,7,8,9,6,7,8,9,6,7,8,9,6,7,8,9,6,7,8,9,6,7,8,9,6,7,8,9,6,7,8,9,6,7,8,9,6,7,8,9,6,7,8,9,6,7,8,9,6,7,8,9,6,7,8,9
16,17,18,19,16,17,18,19,16,17,18,19,16,17,18,19,16,17,18,19,16,17,18,19,16,17,18,19,16,17,18,19,16,17,18,19,16,17,18,19,16,17,18,19,16,17,18,19,16,17,18,19,16,17,18,19,16,17,18,19,16,17,18,19,16,17,18,19,16,17,18,19,16,17,18,19,16,17,18,19,16,17,18,19,16,17,18,19,16,17,18,19,16,17,18,19,16,17,18,19
26,27,28,29,26,27,28,29,26,27,28,29,26,27,28,29,26,27,28,29,26,27,28,29,26,27,28,29,26,27,28,29,26,27,28,29,26,27,28,29,26,27,28,29,26,27,28,29,26,27,28,29,26,27,28,29,26,27,28,29,26,27,28,29,26,27,28,29,26,27,28,29,26,27,28,29,26,27,28,29,26,27,28,29,26,27,28,29,26,27,28,29,26,27,28,29,26,27,28,29
6,7,8,9,6,7,8,9,6,7,8,9,6,7,8,9,6,7,8,9,6,7,8,9,6,7,8,9,6,7,8,9,6,7,8,9,6,7,8,9,6,7,8,9,6,7,8,9,6,7,8,9,6,7,8,9,6,7,8,9,6,7,8,9,6,7,8,9,6,7,8,9,6,7,8,9,6,7,8,9,6,7,8,9,6,7,8,9,6,7,8,9,6,7,8,9,6,7,8,9
16,17,18,19,16,17,18,19,16,17,18,19,16,17,18,19,16,17,18,19,16,17,18,19,16,17,18,19,16,17,18,19,16,17,18,19,16,17,18,19,16,17,18,19,16,17,18,19,16,17,18,19,16,17,18,19,16,17,18,19,16,17,18,19,16,17,18,19,16,17,18,19,16,17,18,19,16,17,18,19,16,17,18,19,16,17,18,19,16,17,18,19,16,17,18,19,16,17,18,19
26,27,28,29,26,27,28,29,26,27,28,29,26,27,28,29,26,27,28,29,26,27,28,29,26,27,28,29,26,27,28,29,26,27,28,29,26,27,28,29,26,27,28,29,26,27,28,29,26,27,28,29,26,27,28,29,26,27,28,29,26,27,28,29,26,27,28,29,26,27,28,29,26,27,28,29,26,27,28,29,26,27,28,29,26,27,28,29,26,27,28,29,26,27,28,29,26,27,28,29
6,7,8,9,6,7,8,9,6,7,8,9,6,7,8,9,6,7,8,9,6,7,8,9,6,7,8,9,6,7,8,9,6,7,8,9,6,7,8,9,6,7,8,9,6,7,8,9,6,7,8,9,6,7,8,9,6,7,8,9,6,7,8,9,6,7,8,9,6,7,8,9,6,7,8,9,6,7,8,9,6,7,8,9,6,7,8,9,6,7,8,9,6,7,8,9,6,7,8,9
16,17,18,19,16,17,18,19,16,17,18,19,16,17,18,19,16,17,18,19,16,17,18,19,16,17,18,19,16,17,18,19,16,17,18,19,16,17,18,19,16,17,18,19,16,17,18,19,16,17,18,19,16,17,18,19,16,17,18,19,16,17,18,19,16,17,18,19,16,17,18,19,16,17,18,19,16,17,18,19,16,17,18,19,16,17,18,19,16,17,18,19,16,17,18,19,16,17,18,19
26,27,28,29,26,27,28,29,26,27,28,29,26,27,28,29,26,27,28,29,26,27,28,29,26,27,28,29,26,27,28,29,26,27,28,29,26,27,28,29,26,27,28,29,26,27,28,29,26,27,28,29,26,27,28,29,26,27,28,29,26,27,28,29,26,27,28,29,26,27,28,29,26,27,28,29,26,27,28,29,26,27,28,29,26,27,28,29,26,27,28,29,26,27,28,29,26,27,28,29
6,7,8,9,6,7,8,9,6,7,8,9,6,7,8,9,6,7,8,9,6,7,8,9,6,7,8,9,6,7,8,9,6,7,8,9,6,7,8,9,6,7,8,9,6,7,8,9,6,7,8,9,6,7,8,9,6,7,8,9,6,7,8,9,6,7,8,9,6,7,8,9,6,7,8,9,6,7,8,9,6,7,8,9,6,7,8,9,6,7,8,9,6,7,8,9,6,7,8,9
16,17,18,19,16,17,18,19,16,17,18,19,16,17,18,19,16,17,18,19,16,17,18,19,16,17,18,19,16,17,18,19,16,17,18,19,16,17,18,19,16,17,18,19,16,17,18,19,16,17,18,19,16,17,18,19,16,17,18,19,16,17,18,19,16,17,18,19,16,17,18,19,16,17,18,19,16,17,18,19,16,17,18,19,16,17,18,19,16,17,18,19,16,17,18,19,16,17,18,19
26,27,28,29,26,27,28,29,26,27,28,29,26,27,28,29,26,27,28,29,26,27,28,29,26,27,28,29,26,27,28,29,26,27,28,29,26,27,28,29,26,27,28,29,26,27,28,29,26,27,28,29,26,27,28,29,26,27,28,29,26,27,28,29,26,27,28,29,26,27,28,29,26,27,28,29,26,27,28,29,26,27,28,29,26,27,28,29,26,27,28,29,26,27,28,29,26,27,28,29
6,7,8,9,6,7,8,9,6,7,8,9,6,7,8,9,6,7,8,9,6,7,8,9,6,7,8,9,6,7,8,9,6,7,8,9,6,7,8,9,6,7,8,9,6,7,8,9,6,7,8,9,6,7,8,9,6,7,8,9,6,7,8,9,6,7,8,9,6,7,8,9,6,7,8,9,6,7,8,9,6,7,8,9,6,7,8,9,6,7,8,9,6,7,8,9,6,7,8,9
16,17,18,19,16,17,18,19,16,17,18,19,16,17,18,19,16,17,18,19,16,17,18,19,16,17,18,19,16,17,18,19,16,17,18,19,16,17,18,19,16,17,18,19,16,17,18,19,16,17,18,19,16,17,18,19,16,17,18,19,16,17,18,19,16,17,18,19,16,17,18,19,16,17,18,19,16,17,18,19,16,17,18,19,16,17,18,19,16,17,18,19,16,17,18,19,16,17,18,19
26,27,28,29,26,27,28,29,26,27,28,29,26,27,28,29,26,27,28,29,26,27,28,29,26,27,28,29,26,27,28,29,26,27,28,29,26,27,28,29,26,27,28,29,26,27,28,29,26,27,28,29,26,27,28,29,26,27,28,29,26,27,28,29,26,27,28,29,26,27,28,29,26,27,28,29,26,27,28,29,26,27,28,29,26,27,28,29,26,27,28,29,26,27,28,29,26,27,28,29
6,7,8,9,6,7,8,9,6,7,8,9,6,7,8,9,6,7,8,9,6,7,8,9,6,7,8,9,6,7,8,9,6,7,8,9,6,7,8,9,6,7,8,9,6,7,8,9,6,7,8,9,6,7,8,9,6,7,8,9,6,7,8,9,6,7,8,9,6,7,8,9,6,7,8,9,6,7,8,9,6,7,8,9,6,7,8,9,6,7,8,9,6,7,8,9,6,7,8,9
16,17,18,19,16,17,18,19,16,17,18,19,16,17,18,19,16,17,18,19,16,17,18,19,16,17,18,19,16,17,18,19,16,17,18,19,16,17,18,19,16,17,18,19,16,17,18,19,16,17,18,19,16,17,18,19,16,17,18,19,16,17,18,19,16,17,18,19,16,17,18,19,16,17,18,19,16,17,18,19,16,17,18,19,16,17,18,19,16,17,18,19,16,17,18,19,16,17,18,19
26,27,28,29,26,27,28,29,26,27,28,29,26,27,28,29,26,27,28,29,26,27,28,29,26,27,28,29,26,27,28,29,26,27,28,29,26,27,28,29,26,27,28,29,26,27,28,29,26,27,28,29,26,27,28,29,26,27,28,29,26,27,28,29,26,27,28,29,26,27,28,29,26,27,28,29,26,27,28,29,26,27,28,29,26,27,28,29,26,27,28,29,26,27,28,29,26,27,28,29
6,7,8,9,6,7,8,9,6,7,8,9,6,7,8,9,6,7,8,9,6,7,8,9,6,7,8,9,6,7,8,9,6,7,8,9,6,7,8,9,6,7,8,9,6,7,8,9,6,7,8,9,6,7,8,9,6,7,8,9,6,7,8,9,6,7,8,9,6,7,8,9,6,7,8,9,6,7,8,9,6,7,8,9,6,7,8,9,6,7,8,9,6,7,8,9,6,7,8,9
16,17,18,19,16,17,18,19,16,17,18,19,16,17,18,19,16,17,18,19,16,17,18,19,16,17,18,19,16,17,18,19,16,17,18,19,16,17,18,19,16,17,18,19,16,17,18,19,16,17,18,19,16,17,18,19,16,17,18,19,16,17,18,19,16,17,18,19,16,17,18,19,16,17,18,19,16,17,18,19,16,17,18,19,16,17,18,19,16,17,18,19,16,17,18,19,16,17,18,19
26,27,28,29,26,27,28,29,26,27,28,29,26,27,28,29,26,27,28,29,26,27,28,29,26,27,28,29,26,27,28,29,26,27,28,29,26,27,28,29,26,27,28,29,26,27,28,29,26,27,28,29,26,27,28,29,26,27,28,29,26,27,28,29,26,27,28,29,26,27,28,29,26,27,28,29,26,27,28,29,26,27,28,29,26,27,28,29,26,27,28,29,26,27,28,29,26,27,28,29
6,7,8,9,6,7,8,9,6,7,8,9,6,7,8,9,6,7,8,9,6,7,8,9,6,7,8,9,6,7,8,9,6,7,8,9,6,7,8,9,6,7,8,9,6,7,8,9,6,7,8,9,6,7,8,9,6,7,8,9,6,7,8,9,6,7,8,9,6,7,8,9,6,7,8,9,6,7,8,9,6,7,8,9,6,7,8,9,6,7,8,9,6,7,8,9,6,7,8,9
16,17,18,19,16,17,18,19,16,17,18,19,16,17,18,19,16,17,18,19,16,17,18,19,16,17,18,19,16,17,18,19,16,17,18,19,16,17,18,19,16,17,18,19,16,17,18,19,16,17,18,19,16,17,18,19,16,17,18,19,16,17,18,19,16,17,18,19,16,17,18,19,16,17,18,19,16,17,18,19,16,17,18,19,16,17,18,19,16,17,18,19,16,17,18,19,16,17,18,19
26,27,28,29,26,27,28,29,26,27,28,29,26,27,28,29,26,27,28,29,26,27,28,29,26,27,28,29,26,27,28,29,26,27,28,29,26,27,28,29,26,27,28,29,26,27,28,29,26,27,28,29,26,27,28,29,26,27,28,29,26,27,28,29,26,27,28,29,26,27,28,29,26,27,28,29,26,27,28,29,26,27,28,29,26,27,28,29,26,27,28,29,26,27,28,29,26,27,28,29
6,7,8,9,6,7,8,9,6,7,8,9,6,7,8,9,6,7,8,9,6,7,8,9,6,7,8,9,6,7,8,9,6,7,8,9,6,7,8,9,6,7,8,9,6,7,8,9,6,7,8,9,6,7,8,9,6,7,8,9,6,7,8,9,6,7,8,9,6,7,8,9,6,7,8,9,6,7,8,9,6,7,8,9,6,7,8,9,6,7,8,9,6,7,8,9,6,7,8,9
16,17,18,19,16,17,18,19,16,17,18,19,16,17,18,19,16,17,18,19,16,17,18,19,16,17,18,19,16,17,18,19,16,17,18,19,16,17,18,19,16,17,18,19,16,17,18,19,16,17,18,19,16,17,18,19,16,17,18,19,16,17,18,19,16,17,18,19,16,17,18,19,16,17,18,19,16,17,18,19,16,17,18,19,16,17,18,19,16,17,18,19,16,17,18,19,16,17,18,19
26,27,28,29,26,27,28,29,26,27,28,29,26,27,28,29,26,27,28,29,26,27,28,29,26,27,28,29,26,27,28,29,26,27,28,29,26,27,28,29,26,27,28,29,26,27,28,29,26,27,28,29,26,27,28,29,26,27,28,29,26,27,28,29,26,27,28,29,26,27,28,29,26,27,28,29,26,27,28,29,26,27,28,29,26,27,28,29,26,27,28,29,26,27,28,29,26,27,28,29
6,7,8,9,6,7,8,9,6,7,8,9,6,7,8,9,6,7,8,9,6,7,8,9,6,7,8,9,6,7,8,9,6,7,8,9,6,7,8,9,6,7,8,9,6,7,8,9,6,7,8,9,6,7,8,9,6,7,8,9,6,7,8,9,6,7,8,9,6,7,8,9,6,7,8,9,6,7,8,9,6,7,8,9,6,7,8,9,6,7,8,9,6,7,8,9,6,7,8,9
16,17,18,19,16,17,18,19,16,17,18,19,16,17,18,19,16,17,18,19,16,17,18,19,16,17,18,19,16,17,18,19,16,17,18,19,16,17,18,19,16,17,18,19,16,17,18,19,16,17,18,19,16,17,18,19,16,17,18,19,16,17,18,19,16,17,18,19,16,17,18,19,16,17,18,19,16,17,18,19,16,17,18,19,16,17,18,19,16,17,18,19,16,17,18,19,16,17,18,19
26,27,28,29,26,27,28,29,26,27,28,29,26,27,28,29,26,27,28,29,26,27,28,29,26,27,28,29,26,27,28,29,26,27,28,29,26,27,28,29,26,27,28,29,26,27,28,29,26,27,28,29,26,27,28,29,26,27,28,29,26,27,28,29,26,27,28,29,26,27,28,29,26,27,28,29,26,27,28,29,26,27,28,29,26,27,28,29,26,27,28,29,26,27,28,29,26,27,28,29
6,7,8,9,6,7,8,9,6,7,8,9,6,7,8,9,6,7,8,9,6,7,8,9,6,7,8,9,6,7,8,9,6,7,8,9,6,7,8,9,6,7,8,9,6,7,8,9,6,7,8,9,6,7,8,9,6,7,8,9,6,7,8,9,6,7,8,9,6,7,8,9,6,7,8,9,6,7,8,9,6,7,8,9,6,7,8,9,6,7,8,9,6,7,8,9,6,7,8,9
